99999999WWWWW
99999999W000W
WWWWWWWWW0W0W
W0B0B0B0B000W
W0WFWFWFW0BWW
WFFFFFFF0S0W9
W0W0W0W0WBWWW
W0B0B0B0B000W
WWWWWWWWW0W0W
99999999W000W
99999999WWWWW