WWWWWWWW9999999
W000000W9999999
W0BB000WWW99999
W00B0BBB0WWWWW9
WW0WW0FFF0000WW
9W0WSWFFFWWWB0W
9W0W0BFFF00000W
WW0W0BFFFB0W0WW
W00WWWWW0WWW0W9
W000000B000B0W9
WWWWWWWWWWW00W9
9999999999WWWW9