9999999999WWWWWW
9999999999W0000W
WWWWW999WWW0WW0W
WFF0WWWWW0B00W0W
WFF00000B000BW0W
WFF00WW0WW000W0W
WFF0WW0B0WB0BW0W
WFF0W00000B00W0W
WFF0W00B0WWWB00W
WFF0W0B0B00B0WWW
WWW0WW0W0B0000W9
99W0000WSWW0B0W9
99WWWWWWWWW00WW9
9999999999WWWW99