9WWWWWW9
9WF0FFW9
9WF0BFW9
WWW00BWW
W0B00B0W
W0WBWW0W
W000S00W
WWWWWWWW