999WWWWWWWWW
999W000W000W
999W0000000W
WWWWWRWW00WW
W000FFF000W9
W0W0WRWWWBWW
W0B0000B000W
WWWWWS0W000W
9999WWWWWWWW