000WWWWWWWW
WWWW0000F0W
W00B0B0BFSW
W00FWWWWFWW
W0BFB0B00W9
W00F00WWWW9
WWWWWWW9999