999WWWWWWW99999
999W00000W99999
999W0B0B0WW9999
999WWWWWFFWWWWW
WWWWWWFFRF00B0W
W00BSBFFFFWBB0W
W000B0WBWWW000W
WWWWW0000000WWW
9999WWW00WWWW99
999999W00W99999
999999WWWW99999