999WWWWW99
999W0S0W99
999WBBBW99
WWWW000W99
W000F0BWWW
W0BFBF0FWW
W00WFWFWW9
WWWWWWWW99