99WWWWWWWW
99W0000WWW
99W0B0000W
WWW0B0WW0W
WFFF0B000W
WFFFBWB0WW
WWWW0W0B0W
999W000S0W
999WWWWWWW