WWWW99999999999
W00W99999999999
W00WWWWWWWWWW99
W0000WW00000W99
WFFW0000BBW0W99
WFF00WW000B0WWW
WFFW00WWBW0B00W
WFF000W0SB0B00W
WFFW00W0B0B000W
W0F000W0B0B0WWW
W00W00W000WWW99
W00W0000WWW9999
WWWWWWWWW999999
999999999999999