999999WWWW99999
999999W00WWWWWW
999999W0000W00W
999999W0BB0000W
WWWWWWWBW00W00W
W00WF0FF0WWWBWW
W00WFWRFB00000W
W00WFWFRW0W000W
W0BBFFFFW0WWWWW
W0SB0W0WW0W9999
W0BBBW0000W9999
W0000WWWWWW9999
WWWWWW999999999