WWWWWWWW9
W000000W9
W0WBB00W9
W0FFFW0W9
WWFFFB0WW
9W0WW0B0W
9WB00B00W
9W00W00SW
9WWWWWWWW