WWWWWWWWW99
W0000000W99
W00B0B0BW99
WW0WBWW0W99
9W0FF0FFWW9
9WWFF0FF0W9
99W0WWBW0WW
99WB0B0B00W
99W000000SW
99WWWWWWWWW
99999999999