WWWWW999999
W000WWWWWWW
W0B00FF0B0W
WWB00FFBBSW
9W000FF0B0W
9WWWWWWWWWW