999999WWWWWWWWW
999999W0000000W
999999WB0BBB00W
999999W000W0B0W
999999W000BSB0W
9999WWWB0B0W0WW
9999W000BWBW0W9
WWWWW0W00W000W9
WFFF00W0BW0WWW9
WFFFFF000W0W999
WFFFFFW0BW0W999
WWWWWWWW000W999
9999999WWWWW999