WWWWWWWWW9
W000WW00W9
W0W0B0B0W9
W00RFW00W9
WW0WFSFWW9
WWBWWWRWWW
W00000000W
W000WW0W0W
WWWWWW000W
99999WWWWW