WWWWW99999999999
WFFFW9WWWWW99999
WFFFWWW000W99999
WFFFF000BBWWWWW9
WFFFF00W00W000WW
WFFWBWWWW0WBW00W
WW0B00W00000BB0W
W00BW0S0B0BBW00W
W0B0B0B0W000B0WW
W000W00B0WW000W9
WWWWWW000WWWWWW9
99999WWWWW999999