9WWWWWWWWW9
9W000W000W9
9W0BBBBB0W9
WW0B0B0B0W9
W0B00S000W9
W0B0WWWW0WW
W00WFFFFF0W
WW00FFFFF0W
9WWWWWWWWWW
99999999999