99WWWWWWWWWW
WWW000F0000W
W000WWBWW00W
W0SBF0F0FBWW
WW0BWWBWW0W9
9W0000F000W9
9WWWWWWWWWW9