999999999WWWWW99
999999999W000W99
WWWWWWWWWW0R0WWW
W0000000000F000W
W0BBBBRRRRBFFFSW
W0000000000F000W
WWWWWWWWWW0R0WWW
999999999W000W99
999999999WWWWW99
