9999WWWWWW9999
99WWW0000WWW99
99W000WB000WWW
99W000B000BB0W
99W0BB0WB0000W
99WW000B000B0W
WWWWWW0WBWWWWW
WFFS0WB00W9999
WFWFF00BWW9999
WFFFFBW0W99999
WFFFF000W99999
WWWWWWWWW99999