WWWW99999999999
W00WWW999999999
W0B00WWW9999999
W0B0B00WWW99999
W0B0B0B00WWW999
W0B0B0B0000W999
W0B0B00W000WW99
W0B00WW0BBB0W99
WS0WWWW00000WW9
WW0W9WFBBBBBFW9
9W0WWWFFFFFFFWW
9W000FRRRRRRRFW
9WWWWFFFFFFFFFW
9999WWWWWWWWWWW