999WWWWWW
WWWWF00SW
W00BBB00W
WFWWFWWFW
W000B000W
W00BFW0WW
WWWW000W9
999WWWWW9