999999WWWW9
WWWWWWW00W9
W0000B000W9
W000BWWSBW9
WWBWFFFW0W9
9W0BFFF00W9
9W0WF0FW0WW
9W000W0WB0W
9WB00B0000W
9W00WWWWWWW
9WWWW999999
99999999999