99999WWWWWW
9WWWWWF000W
9W00WFFWW0W
9W00BFF000W
0W00W0FW0WW
WWW0WWBW00W
W0B0000BB0W
W0WBW00W00W
WS00WWWWWWW
WWWWW999999