999999999WWW999
9999WWWWWWSWW99
9999WFFFFWB0WW9
9999WFFFFW0B0W9
9999WFFFF0B00W9
9999W0FFFW000W9
WWWWWW0WWWWW0WW
W0B0B000B00W00W
W0000BB000B0B0W
WWW0B0B0B00WWWW
99WW000B0B0W999
999W00WWWWWW999
999WWWW99999999