999WWWWWW99
999W0FFFW99
WWWWFFFFW99
W00WWWB0WWW
W0B0B00BB0W
WS0B0B0000W
W000WWW000W
WWWWW9WWWWW