WWWWWWWW9
WFFFFFFW9
W00B0W0WW
W0B0W0B0W
WWB0B0B0W
9W00S000W
9WWWWWWWW
999999999