WWWWWWW99
W00FB0WWW
W0FBFB00W
WRBFBFS0W
W0FBFB0WW
W00FB00W9
WWWWWWWW9