99WWWWW99
WWW0S0WWW
W00B0B00W
W0RFRFR0W
W0FB0BF0W
W0RFRFR0W
W00B0B00W
WWWWWW00W
99999WWWW