99WWWWW9999
99W000W9999
WWWBFBWWWWW
W000F0B000W
W0WWBWW0S0W
W000F0WWWWW
WWW0F0W9999
99W000W9999
99WWWWW9999