000WWWWWWW999
WWWW00000W999
W000FWWW0W999
W0W0W0000WW99
W0W0B0BWF0W99
W0W00R00W0W99
W0FWB0B0W0W99
WW0000W0W0WWW
9W0WWWF0000SW
9W00000WW000W
9WWWWWWWWWWWW