99999WWWWWWW9
99999W00W00W9
99999W00BB0W9
WWWWWW0BW00W9
WFFFWWW0W00WW
WF00W00B0W00W
WF0000B0B0B0W
WF00W00B0W00W
WFFFWWW0W00WW
WWWWWW0B000W9
99999W0SW00W9
99999WWWWWWW9