WWWWWW999
W0000W999
W0BBBWW99
W00WFFWWW
WW00FFB0W
9W00S000W
9WWWWWWWW