9999WWWWW999999
WWWWW000W999999
W000B0S0W999999
W00B0WFWWWWW999
WWB0WWFWW00WWWW
9W00FFFFF0BW00W
9W0BWWFWW00WB0W
9W000WFWW00000W
9WWW0B0WWWWW0WW
999W0WB00000B0W
999W0000WWW000W
999WWWWWW9WWWWW