WWWWWWWWWWWWW
W00B0B0BFRFFW
W0B0B0B0RFFFW
W00B0B0BFRFFW
W0B0B0B0RFFFW
W00B0B0BFRFFW
W0B0B0B0RFFFW
W00B0B0BFRFFW
W0B0B0B0RFFFW
W00B0B0BFRFFW
WSB0B0B0RFFFW
WWWWWWWWWWWWW
9999999999999