WWWWWWW9999
W0SW00WWWWW
W0BB00B000W
W00WFWWBW0W
WWBWFFF000W
WW0FFFWWBWW
W00WWFWW00W
W00B00B000W
W00W000W00W
WWWWWWWWWWW