9WWWWWWWWWWWW
9W000WW00WWWW
9W0B00000000W
9WWBWWW0WW00W
9W00WW0R0W0WW
9W0BFFFFFF0W9
WW0WWW0F0W0W9
W00000BWWWBW9
W000W0000BSW9
WWWWWBW0WWWW9
9999W000W9999
9999WWWWW9999