999WWWWWWWWWW9
WWWWFFFFFF00W9
W000FFFFFW00W9
W00WFFFFFF0WW9
WW0WWWWBWWBW00
W0B00B0B000WWW
WSBB0000WW000W
W0W00BBWW00W0W
W000B00W0BB00W
W00B00B000WB0W
WWWW000W0B0B0W
999W000W00000W
999WWWWWWWWWWW