99999WWWWWW999
999WWW0000WW99
999W000WW00W99
9WWWBWW00W0W99
WW00000FFW0W99
W00BWBWRFW0W99
W0BB0SWFRW0WWW
W00BB0WFFW000W
WW0000WFFB000W
9WWWBWWF0W0WWW
999W00WWW00W99
999WW00000WW99
9999WWWWWWW999
99999999999999