999999WWWWWWW9
99999WW00000WW
9999WW00BWW00W
9999W00W000B0W
9999W0W00W0W0W
9999W0B0B00B0W
WWWWWWW0WBW00W
W00000000000WW
W0R0SBRRFWWWW9
WWFFFFFFWWW999
9WWWWWWWW99999
