WWWWWWW
WFFBFFW
WFFWFFW
W0BBB0W
W00B00W
W0BBB0W
W00WS0W
WWWWWWW