9999WWWW9999
WWWWW00WWWWW
W0000B000B0W
W00BWBWW000W
WWW0WFRF0WWW
99W0FFF0SW99
99WW0WBWWW99
999W000W9999
999WWWWW9999