99WWWWW99999
99W000WWWWWW
WWWBWF00000W
W0B0FFFW0B0W
W00S0WRB000W
WWWW0000WWWW
999WWWWWW999