99WWWWW999
WWW000WWWW
W000B0B00W
W0B000B0SW
WWWBBWWWWW
99W00FFW99
99WFFFFW99
99WWWWWW99