99WWWWWWWWW99999
99W0000W00W99999
WWW0WB00B0WWWW99
W00B00WWFFW00WWW
W0W00B0WFFB0B00W
W0BB00BWFF00W00W
WW00W00FFFWB000W
9WB0S0WFFFW0B00W
9W0000WFFFB000WW
9W0WWB0WWW000WW9
9W000B00000WWW99
9W00WWWWWWWW9999
9WWWW99999999999